{
    "playerPos": [
        19,21
    ],
    "tiles": [
        0, 3, 4, 5, 0, 0, 0, 0, 0, 0, 0, 0, 0, 0, 0, 0, 0, 0, 0, 0, 0, 0, 0, 0, 0, 0, 0, 0, 0, 0, 0, 0, 0, 0, 0, 0, 0, 0, 0, 0,
        0, 9,10,11, 0, 0, 0, 0, 0, 0, 0, 0, 0, 0, 0, 0, 0, 0, 0, 0, 0, 0, 0, 0, 0, 0, 3, 8, 8, 8, 8, 8, 8, 8, 8, 8, 4, 5, 0, 0,
        0, 1,10, 2, 0, 0, 0, 0, 0, 0, 0, 0, 0, 0, 0, 0, 0, 0, 0, 0, 0, 0, 0, 0, 0, 0, 9,10,10,10,10,10,10,10,10,10,10,11, 0, 0,
        0, 1,10, 2, 0, 0, 0, 0, 0, 0, 0, 0, 0, 0, 0, 0, 0, 0, 0, 0, 0, 0, 0, 0, 0, 0, 1,10,10,14,14,14,14,14,14,14,16,17, 0, 0,
        0, 1,10, 2, 0, 0, 0, 0, 0, 0, 0, 0, 0, 0, 0, 0, 0, 0, 0, 0, 0, 0, 0, 0, 0, 0, 1,10, 2, 0, 0, 0, 0, 0, 0, 0, 0, 0, 0, 0,
        0, 1,10, 2, 0, 0, 0, 0, 0, 0, 0, 0, 0, 0, 0, 0, 0, 0, 0, 0, 0, 0, 0, 0, 0, 0, 1,10, 2, 0, 0, 0, 0, 0, 0, 0, 0, 0, 0, 0,
        0, 1,10, 2, 0, 0, 0, 0, 0, 0, 0, 0, 0, 0, 0, 0, 0, 0, 0, 0, 0, 0, 0, 0, 0, 0, 1,10, 2, 0, 0, 0, 0, 0, 0, 0, 0, 0, 0, 0,
        0, 1,10, 2, 0, 0, 0, 0, 0, 0, 0, 0, 0, 0, 0, 0, 0, 0, 0, 0, 0, 0, 0, 0, 0, 0, 1,10, 2, 0, 0, 0, 0, 0, 0, 0, 0, 0, 0, 0,
        0, 1,10, 2, 0, 0, 0, 0, 0, 0, 0, 0, 0, 0, 0, 0, 0, 0, 0, 0, 0, 0, 0, 0, 0, 0, 1,10, 2, 0, 0, 0, 0, 0, 0, 0, 0, 0, 0, 0,
        0, 1,10, 2, 0, 0, 0, 0, 0, 0, 0, 0, 0, 0, 0, 0, 0, 0, 0, 0, 0, 0, 0, 0, 0, 0, 1,10, 2, 0, 0, 0, 0, 0, 0, 0, 0, 0, 0, 0,
        0, 1,10, 2, 0, 0, 0, 0, 0, 0, 0, 0, 0, 0, 0, 0, 0, 0, 0, 0, 0, 0, 0, 0, 0, 0, 1,10, 2, 0, 0, 0, 0, 0, 0, 0, 0, 0, 0, 0,
        0, 1,10, 2, 0, 0, 0, 0, 0, 0, 0, 0, 0, 0, 0, 0, 0, 0, 0, 0, 0, 0, 0, 0, 0, 0, 1,10, 2, 0, 0, 0, 0, 0, 0, 0, 0, 0, 0, 0,
        0, 1,10, 2, 0, 0, 0, 0, 0, 0, 0, 0, 0, 0, 0, 0, 0, 0, 0, 0, 0, 0, 0, 0, 0, 0, 1,10, 2, 0, 0, 0, 0, 0, 0, 0, 0, 0, 0, 0,
        0, 1,10, 2, 0, 0, 0, 0, 0, 0, 0, 0, 0, 0, 0, 0, 0, 0, 0, 0, 0, 0, 0, 0, 0, 0, 1,10, 2, 0, 0, 0, 0, 0, 0, 0, 0, 0, 0, 0,
        0, 1,10,12, 8, 8, 5, 0, 0, 0, 0, 0, 0, 0, 0, 0, 0, 0, 0, 0, 0, 0, 0, 0, 0, 0, 1,10, 2, 0, 0, 0, 0, 0, 0, 0, 0, 0, 0, 0,
        0, 9,10,10,10,10,11, 0, 0, 0, 0, 0, 0, 0, 0, 0, 0, 0, 0, 0, 0, 0, 0, 0, 0, 0, 1,10, 2, 0, 0, 0, 0, 0, 0, 0, 0, 0, 0, 0,
        0,15,14,14,10,10, 2, 0, 0, 0, 0, 0, 0, 0, 0, 0, 0, 0, 0, 0, 0, 0, 0, 0, 0, 0, 1,10, 2, 0, 0, 0, 0, 0, 0, 0, 0, 0, 0, 0,
        0, 0, 0, 0, 1,10, 2, 0, 0, 0, 0, 0, 0, 0, 0, 0, 0, 0, 0, 0, 0, 0, 0, 0, 0, 0, 1,10, 2, 0, 0, 0, 0, 0, 0, 0, 0, 0, 0, 0,
        0, 0, 0, 0, 1,10,12, 8, 8, 8, 8, 5, 0, 0, 0, 0, 0, 0, 0, 0, 0, 0, 0, 0, 0, 0, 1,10, 2, 0, 0, 0, 0, 0, 0, 0, 0, 0, 0, 0,
        0, 0, 0, 0, 9,10,10,10,10,10,10,11, 0, 0, 0, 0, 0, 0, 0, 0, 0, 0, 0, 0, 0, 0, 1,10, 2, 0, 0, 0, 0, 0, 0, 0, 0, 0, 0, 0,
        0, 0, 0, 0,15,14,14,14,14,10,10, 2, 0, 0, 0, 0, 0, 0, 0, 0, 0, 0, 0, 0, 0, 0, 1,10, 2, 0, 0, 0, 0, 0, 0, 0, 0, 0, 0, 0,
        0, 0, 0, 0, 0, 0, 0, 0, 0, 1,10,12, 8, 8, 8, 8, 8, 8, 8, 8, 8, 8, 8, 8, 8, 8,13,10, 2, 0, 0, 0, 0, 0, 0, 0, 0, 0, 0, 0,
        0, 0, 0, 0, 0, 0, 0, 0, 0, 9,10,10,10,10,10,10,10,10,10,10,10,10,10,10,10,10,10,10,11, 0, 0, 0, 0, 0, 0, 0, 0, 0, 0, 0,
        0, 0, 0, 0, 0, 0, 0, 0, 0,15,14,14,14,14,14,14,14,14,14,14,14,14,14,14,14,14,14,14,17, 0, 0, 0, 0, 0, 0, 0, 0, 0, 0, 0,
        0, 0, 0, 0, 0, 0, 0, 0, 0, 0, 0, 0, 0, 0, 0, 0, 0, 0, 0, 0, 0, 0, 0, 0, 0, 0, 0, 0, 0, 0, 0, 0, 0, 0, 0, 0, 0, 0, 0, 0
    ],
    "moneyBagPositions":[
        [10, 1],
        [31, 4],
        [ 4, 6],
        [14, 9],
        [20, 9],
        [15,16],
        [20,16]

    ],
    "gemPositions": [
        [10,5 ],
        [10,7 ],
        [10,9 ],
        [10,11],
        [10,13],
        [12,5 ],
        [12,7 ],
        [12,9 ],
        [12,11],
        [12,13],
        [18,5 ],
        [18,7 ],
        [18,9 ],
        [18,11],
        [18,13],
        [33,9 ],
        [33,11],
        [33,13],
        [35,9 ],
        [35,11],
        [35,13],
        [37,9 ],
        [37,11],
        [37,13],
        [35,23],
        [37,23],
        [37,21],
        [3 ,23],
        [1 ,23],
        [1 ,21]
   ]
}