{
    "playerPos": [
        19,21
    ],
    "tiles": [
        0, 3, 4, 8, 8, 8, 8, 8, 8, 8, 8, 8, 8, 5, 0, 0, 0, 0, 0, 0, 0, 0, 0, 0, 0, 0, 0, 0, 0, 0, 0, 0, 3, 8, 8, 4, 5, 0, 0, 0,
        0, 9,10,10,10,10,10,10,10,10,10,10,10,11, 0, 0, 0, 0, 0, 0, 0, 0, 0, 0, 0, 0, 0, 0, 0, 0, 0, 0, 9,10,10,10,11, 0, 0, 0,
        0,15,16,14,14,14,14,14,14,14,14, 7,10, 2, 0, 0, 0, 0, 0, 0, 0, 0, 0, 0, 0, 0, 0, 0, 0, 0, 0, 0, 1,10, 6,14,17, 0, 0, 0,
        0, 0, 0, 0, 0, 0, 0, 0, 0, 0, 0, 1,10, 2, 0, 0, 0, 0, 0, 0, 0, 0, 0, 0, 0, 0, 0, 0, 0, 0, 0, 0, 1,10, 2, 0, 0, 0, 0, 0,
        0, 0, 0, 0, 0, 0, 0, 0, 0, 0, 0, 1,10, 2, 0, 0, 0, 0, 0, 0, 0, 0, 0, 0, 0, 0, 0, 0, 0, 0, 0, 0, 1,10, 2, 0, 0, 0, 0, 0,
        0, 0, 0, 0, 0, 0, 0, 0, 0, 0, 0, 1,10, 2, 0, 0, 0, 0, 0, 0, 0, 0, 0, 0, 0, 0, 0, 0, 0, 0, 0, 0, 1,10, 2, 0, 0, 0, 0, 0,
        0, 0, 0, 0, 0, 0, 0, 0, 0, 0, 0, 1,10, 2, 0, 0, 0, 0, 0, 0, 0, 0, 0, 0, 0, 0, 0, 0, 0, 0, 0, 0, 1,10, 2, 0, 0, 0, 0, 0,
        0, 0, 0, 0, 0, 0, 0, 0, 0, 0, 0, 1,10, 2, 0, 0, 0, 0, 0, 0, 0, 0, 0, 0, 0, 0, 0, 0, 0, 0, 0, 0, 1,10, 2, 0, 0, 0, 0, 0,
        0, 0, 0, 0, 0, 0, 0, 0, 0, 0, 0, 1,10, 2, 0, 0, 0, 0, 0, 0, 0, 0, 0, 0, 0, 0, 0, 0, 0, 0, 0, 0, 1,10, 2, 0, 0, 0, 0, 0,
        0, 0, 0, 0, 0, 0, 0, 0, 0, 0, 0, 1,10, 2, 0, 0, 0, 0, 0, 0, 0, 0, 0, 0, 0, 0, 0, 0, 0, 0, 0, 0, 1,10, 2, 0, 0, 0, 0, 0,
        0, 0, 0, 0, 0, 0, 0, 0, 0, 0, 0, 1,10, 2, 0, 0, 0, 0, 0, 0, 0, 0, 0, 0, 0, 0, 0, 0, 0, 0, 0, 0, 1,10, 2, 0, 0, 0, 0, 0,
        0, 0, 0, 0, 0, 0, 0, 0, 0, 0, 0, 1,10, 2, 0, 0, 0, 0, 0, 0, 0, 0, 0, 0, 0, 3, 8, 8, 8, 8, 8, 8,13,10, 2, 0, 0, 0, 0, 0,
        0, 0, 0, 0, 0, 0, 0, 0, 0, 0, 0, 1,10, 2, 0, 0, 0, 0, 0, 0, 0, 0, 0, 0, 0, 9,10,10,10,10,10,10,10,10,11, 0, 0, 0, 0, 0,
        0, 0, 0, 0, 0, 0, 0, 0, 0, 0, 0, 1,10, 2, 0, 0, 0, 0, 0, 0, 0, 0, 0, 0, 0, 1,10, 6,14,14,14,14,14,14,17, 0, 0, 0, 0, 0,
        0, 0, 0, 0, 0, 0, 0, 0, 0, 0, 0, 1,10, 2, 0, 0, 0, 0, 0, 0, 0, 0, 0, 0, 0, 1,10, 2, 0, 0, 0, 0, 0, 0, 0, 0, 0, 0, 0, 0,
        0, 0, 0, 0, 0, 0, 0, 0, 0, 0, 0, 1,10, 2, 0, 0, 0, 0, 0, 0, 0, 0, 0, 0, 0, 1,10, 2, 0, 0, 0, 0, 0, 0, 0, 0, 0, 0, 0, 0,
        0, 0, 0, 0, 0, 0, 0, 0, 0, 0, 0, 1,10, 2, 0, 0, 0, 0, 0, 0, 0, 0, 0, 0, 0, 1,10, 2, 0, 0, 0, 0, 0, 0, 0, 0, 0, 0, 0, 0,
        0, 0, 0, 0, 0, 0, 0, 0, 0, 0, 0, 1,10, 2, 0, 0, 0, 0, 0, 0, 0, 0, 0, 0, 0, 1,10, 2, 0, 0, 0, 0, 0, 0, 0, 0, 0, 0, 0, 0,
        0, 0, 0, 0, 0, 0, 0, 0, 0, 0, 0, 1,10, 2, 0, 0, 0, 0, 0, 0, 0, 0, 0, 0, 0, 1,10, 2, 0, 0, 0, 0, 0, 0, 0, 0, 0, 0, 0, 0,
        0, 0, 0, 0, 0, 0, 0, 0, 0, 0, 0, 1,10, 2, 0, 0, 0, 0, 0, 0, 0, 0, 0, 0, 0, 1,10, 2, 0, 0, 0, 0, 0, 0, 0, 0, 0, 0, 0, 0,
        0, 0, 0, 0, 0, 0, 0, 0, 0, 0, 0, 1,10, 2, 0, 0, 0, 0, 0, 0, 0, 0, 0, 0, 0, 1,10, 2, 0, 0, 0, 0, 0, 0, 0, 0, 0, 0, 0, 0,
        0, 0, 0, 0, 0, 0, 0, 0, 0, 0, 0, 1,10,12, 8, 8, 8, 8, 8, 8, 8, 8, 8, 8, 8,13,10, 2, 0, 0, 0, 0, 0, 0, 0, 0, 0, 0, 0, 0,
        0, 0, 0, 0, 0, 0, 0, 0, 0, 0, 0, 9,10,10,10,10,10,10,10,10,10,10,10,10,10,10,10,11, 0, 0, 0, 0, 0, 0, 0, 0, 0, 0, 0, 0,
        0, 0, 0, 0, 0, 0, 0, 0, 0, 0, 0,15,14,14,14,14,14,14,14,14,14,14,14,14,14,14,14,17, 0, 0, 0, 0, 0, 0, 0, 0, 0, 0, 0, 0,
        0, 0, 0, 0, 0, 0, 0, 0, 0, 0, 0, 0, 0, 0, 0, 0, 0, 0, 0, 0, 0, 0, 0, 0, 0, 0, 0, 0, 0, 0, 0, 0, 0, 0, 0, 0, 0, 0, 0, 0
    ],
    "moneyBagPositions":[
        [18,1],
        [24,1],
        [15,15],
        [1,6],
        [8,6],
        [3,15],
        [6,15]
    ],
    "gemPositions": [
        [3,5 ],
        [3,7 ],
        [3,9 ],
        [3,11],
        [1,9 ],
        [1,11],
        [8,9 ],
        [8,11],
        [3,13],
        [6,5 ],
        [6,7 ],
        [6,9 ],
        [6,11],
        [6,13],
        
        [17,6],
        [17,8],
        [19,6],
        [19,8],
        [21,6],
        [21,8],
        [23,6],
        [23,8],
        [25,6],
        [25,8],
        [27,6],
        [27,8],
    
        [17,15],
        [20,15],
        [20,17],
        [17,17],
        [23,17],
        [14,17],
        [17,19],
        [20,19],
        
        [35,17],
        [35,20],
        [32,20],
        [32,17],
    

        
        [3 ,23],
        [1 ,23],
        [1 ,21]
   ],
   "spawnerPositions":[
    [34,1,5,11],
    [4,1,5,12]



    ]
}